----------	
ARE	AA R
ARE(2)	ER
FIFTH	F IH F TH
FIFTH(2)	F IH TH
FIRST	F ER S T
FITH	F IH TH
FIVE	F AY V
FLOOR	F L AO R
FOUR	F AO R
FOURTH	F AO R TH
GROUND	G R AW N D
IS	IH Z
ON	AA N
ON(2)	AO N
ONE	W AH N
ONE(2)	HH W AH N
SECOND	S EH K AH N D
THE	DH AH
THE(2)	DH IY
THIRD	TH ER D
THIS	DH IH S
THREE	TH R IY
TWO	T UW
YOU	Y UW
